ar=Arabic
cs=Czech
da=Danish
de=German
de-ch=Swiss German
en-dv=Dvorak
en-gb=British
en-us=U.S.
es=Spanish
et=Estonian
fi=Finnish
fo=Faroese
fr=French
fr-ca=Canadian French - CSA
he=Hebrew
hr=Croatian
hu=Hungarian
is=Icelandic
it=Italian
ja=Japanese
ko=Korean
lt=Lithuanian
lv=Latvian
mk=Macedonian
nl=Dutch
no=Norwegian
pl=Polish
pt=Portuguese
ru=Russian
sl=Slovenian
sv=Swedish
th=Thai
tr=Turkish